############################################
#..............#...#.......................#
#....G##########.#.#########################
#................#.................G.......#
#.oo.#######################################
#..................V.......................#
#..................................G.......#
#..........................................#
#....G.....................................#
#.......oooooooooooooo.....................#
############################################
