############################################
#..............#...#.......................#
#....G##########.#.#########################
#.............V..#.................G.......#
#.oo.#######################################
#..........................................#
#..................................G.......#
#..........................................#
#....G.....................................#
#.......oooooooooooooo.....................#
############################################
