############################################
#..............#...#.......................#
#....G##########.#.#########################
#.............,..#.................G.......#
#.oo.#######################################
####.......................................#
#..................................G.......#
#..#####################...................#
#....G.................#####################
#.......oooooooooooooo....................V#
############################################
