############################
#.o......#...o........V....#
#....########.#.############
#..........#...........o...#
#.oo.##..################..#
#....G...#.......###.......#
#######..o....####...#######
#..o.....#######........o..#
##...G............##########
#...############..o........#
#..##....##..###..#####.o..#
#..####.......###....####..#
#.o...######o......####....#
#..#####......####.#######.#
#....G..oo........oo..G....#
############################
