############################
#....#............#....o..V#
#.##.#.########.#.#.##.#.#.#
#.##........#.......##.#.#.#
#....######.#.######.......#
###.##....#.#.#....#.###.###
#...#..##.#.#.#.##.....#...#
#G#.#..##.#...#.##..#.#..#V#
#.###..##....##.#####.#....#
#....#.....o..........o..#.#
#.#..#.#######.#.#######.#.#
#.#....#.....#.#.......#.#.#
#.#.####.###.#########.#.#.#
#G#.......#.......o....#...#
############################