############################
#o...#.......V....#..G.o...#
#.##.#.########.#.#.##.#.#.#
#.##........#.......##.#.#.#
#....######.#.######....#..#
###.##....#.#.#....#.###.###
#...#..##.#.#.#.##.#...#...#
#.#.#..##.#...#.##.G.#.#.#.#
#.###..##....##.#####+#.#..#
#....#.........#.#.......#.#
#.####.#######.#.#######.#.#
#.#....#.....#.#.......#.#.#
#.#.####.###.#########.#.#.#
#.#......G#.......o...G#...#
############################