############################
#o...#.......V....#..G.o...#
#.##.#.########.#.#.##.#.#.#
#.##........#.......##.#.#.#
#....######.#.######.......#
###.##....#.#.#....#.###.###
#...#..##.#.#.#.##.....#...#
#.#.#..##.#...#.##.G#.#..#.#
#.###..##....##.#####.#....#
#....#.....o..........o..#.#
#.#..#.#######.#.#######.#.#
#.#....#.....#.#.......#.#.#
#.#.####.###.#########.#.#.#
#.#......G#.......o...G#...#
############################