############################
#o...#.......V....#....o...#
#.##.#.########.#.#.##.#.#.#
#.##........#.......##.#.#.#
#....######.#.######....#..#
###.##....#.#.#....#.###.###
#...#..##.#.#.#.##.#...#...#
#.#.#.G##.#...#.##.G.#.#.#.#
#.###..##....##.#####+#.#..#
#....#.........#.#.......#.#
#.####.#######.#.#######.#.#
#.#....#.....#.#.......#.#.#
#.#.####.###.#########.#.#.#
#.#......G#.......o...G#...#
############################